朔州→假酒案
代码→简称
11时→50分
封建→专制
烟花→汇演
少将→军衔
低压→电网
羊羔→肉
姓名→笔划
月球→勘探者
凉山→彝族
松桃→苗族
直排式→热水器
防盗→报警器
保值→贴补
尝→胜果
英文→译本
地层→标本
赤道→上空
名家→解读
会计→账册
97→诗韵
不畏→艰险
敬献→花篮
毫不→逊色
创维→数码
英山→牌照
司长→梁爱诗
出版署→署长
日内瓦→万国宫
男人→兵阵
红外→太空
宋晓波→篮球
保利→大厦
肌肉→萎缩
搬进→新居
竞→风流
呆坏账→准备金
苦干→实干
自力→食用
题写→片名
彩旗→招展
司长→陈方
粮→间作
练→内功
可比价格→计算
陪同团→团长
旱→育秧
前周→收盘
探矿权→价款
防卫厅→长官
本文→开头
学士→学位
惊→雷
一束束→鲜花
大雪→纷飞
传统式→越野
小白→热线
每日→电讯报
国务卿→塔尔博特
首府→普里什蒂纳
主席台→前排
人间→正道
先行者→孙中山
下世纪→中叶
食堂→就餐
大臣→莫勒姆
不惜→重金
假酒→中毒案
全盘→西化
自民党→干事长
爆出→冷门
师德→标兵
剥夺→政治权利
股东→账户卡
整修→黄帝陵
姓氏→笔划
失职→渎职
洛阳市→政法委
力戒→形式主义
风范→长存
司令员→刘顺尧
新华→文摘
重振→雄风
天王→挑战赛
一揽子→平均价
太原→刚玉
顶尖→高手
生长→调节剂
燃放→烟花
底子→薄
报警→服务台
波音737→客机
陆军→第二十七
水稻→旱育稀植
总署→署长
美特→装饰
亨利→亲王
中南海→怀仁堂
空军→联航队
寻常→百姓家
主→承销商
舞阳→钢铁
朱德→总司令
兖州→矿业
沉痛→哀悼
触角→伸
牛→魔王
宋庆龄→奖学金
正当→竞争法
四库→全书
植树→种草
诸→报端
开除→公职
曲靖→电厂
特派员→马毓真
等待→戈多
浑身→解数
矿产→资源法
环球→时报
孟西安→王鸣媛
敦雷→核
便民→服务卡
民事→诉讼法
贾建舟→刘磊
快乐→天使
名称→前周
重整→信托
惜→贷
俄共→议员团
X—33→表
三毛→从军记
超→Ⅴ
擀→皮
睦邻→互信
钱树根→中将
军衔→警衔
收盘→涨跌幅
深证→成份
封建→农奴
西山→矿务局
围棋→新人王赛
短时→雷雨
越盾→兑换
高楼→林立
鸡皮→汤
吹→口哨
助力→自行车
吃喝→大王
放下→架子
涨潮→时分
食用→酒精
鲁→豫
春秋→战国
博士后→工作站
每股→净资产
保定→一中
甲方→乙方
扫除→青壮年
冀→鲁
外交大臣→沃勒贝克
〕→240
就地→免职
贝尔格莱德→红星队
场场→爆满
秦山→核电
涛声→依旧
深水→航道
兴致→盎然
狼狗→弟弟
总参谋长→熊光楷
二滩→输电
林散之→书法集
长势→喜人
国防军→总司令
法兰西→集萃
复方→丹参
倍加→珍惜
莲花→味精
渡→难关
腔→热血
涨跌幅→成交
合伙→企业法
主观→能动性
核→两用品
算术→平均数
年均→pH值
木→帆船
蒙古国→引渡
宰→客
符福渊→周德武
上访→告状
挽回→败局
火星→探路者
村村→通电
配方→施肥
激光→唱盘
踞→钟山
程序性→商谈
通力→协作
低价→亏本
助理→塞缪尔·伯杰
天士力→复方
徐州→华润
陕西→国力队
议长→贝里
个中→缘由
无党派→民主人士
±→％
大篷车→大嫂
江青→反革命
男生→贾里
随地→吐
心脏病→发作
浩然→正气
业→领头人
诚实→守信
商标→专用权
计→复利
探矿权→使用费
深证→成份股
九年制→义务教育
哟→嗬
纸→诉状
庇护→伞
第三方→介入
活页→文选
招生→简章
前排→就座
古朴→典雅
库贷→挂钩
中上游→防护林
瓶→尿样
廉洁→从政
总参谋长→吴铨叙
惨遭→杀害
诺贝尔奖→获得者
威曼→女士
吐→痰
政务司→司长
税务员→收税
杆→秤
驱逐舰→舰长
社交→场合
迪斯尼→乐园
首席→大法官
2010年→远景
红十字→方队
临汾市→地税局
医治→无效
日军→南京大屠杀
遗物→陈列馆
孙子→兵法
伤痕→累累
众目睽睽→之下
领→风骚
显→身手
台网→测定
问问→孙子
肃→毒
齐鲁→石化
姑息→迁就
碘→钙
七十九→师
助理→万经常
住友→信托
雷雨→大风
大公储→亨利
苦苦→挣扎
巾帼→建功
无线→寻呼
刊→播
人间→烟火
分忧→解难
东欧→剧变
地质→矿产部
线条→流畅
长征→突击手
后果→不堪设想
中兴→通讯杯
正月→初四
尘土→飞扬
前场→任意球
东条英机→歌功颂德
扬子江→药业
冰球→C组
军旗→飘飘
李维平→刘建春
盛情→款待
忙于→应酬
绵阳→高新区
封建→专制主义
中远→澳洲
财政司→司长
南斯拉夫联盟→塞尔维亚共和国
驾→马车
章→附则
总参谋长→钱树根
吉林市→中院
权衡→利弊
山体→滑坡
律政司→司长
扭亏→无望
朗朗→星空
政要→电贺
虎踞→钟山
师→二三五
政令→畅通
3∶2→险胜
挺立→潮头
越过→温饱线
开滦→矿工
导弹→弹头
葛洲坝→船闸
世→夏茸尕布
无党派→爱国人士
国王→诺罗敦·西哈努克
森林法→修正案
识→大体
苏→财综
署长→钱冠林
花季→雨季
迁入→新居
公道→正派
医师→刘津
三八→红旗手
本社→驻外
破格→提拔
保温→简易房
瑶族→舞曲
孟西安→祁勇
〔→1992
本法→第三十九
春蕾→女童
高保真→音响
林州市→国税局
襄→石
火险→隐患
嗬→嗬
临沂→造纸厂
特种→用途林
星期日→泰晤士报
剥→皮
恩→专线
掣→签
年过→八旬
同级→国库
笔划→排列
熊光楷→中将
亚洲区→预赛
选票→2048
苦练→内功
中南海→紫光阁
评估→基准日
塑料→包装物
主席台→就座
入党→申请书
射击→射箭
审结→一审
蒜→农
一中→分校
体察→民情
助理→陈健
求知→欲望
社长→王启人
1992→〕
多头→开户
署长→于友先
纽伯瑞→儿童文学
苏→三山
幅员→辽阔
饮用→豆奶
累累→硕果
柏油→马路
执白→中盘
标本→长廊
布伦特→原油
举世→公认
＊→＊
招收→保送生
帆张网→渔船
奥运→争光
国王→哈桑二世
席卷→大西南
猛烈→抨击
嗬→哟
毫不→畏惧
台上→台下
驳回→上诉
百日→集训
土壤→墒情
种族→共处
三北→防护林
2460→平方公里
瓶→掣
撑→危局
高考→落榜
骗取→钱财
怒江→峡谷
大庆市→中级
开动→脑筋
脸→难看
芳草→萋萋
羽毛球→天王
寒风→刺骨
海面→风力
越权→减免税
刮风→下雨
净现金→流量
花园→洋房
京丰→宾馆
中保→人寿保险
采矿权→价款
餐→摩托
免征→关税
寒气→袭
采矿权→使用费
政务院→参事
三毛→流浪
干事→中岛宏
江西省→景德镇市
新华→字典
郑州市→二七
植被→恢复费
沃尔特→水库
灯塔→世家
红木→家具
白沟→箱包
体操→系列赛
索贿→受贿
