爆炸→物品
私营→企业主
被→评为
从来→没有
1997→年度
走→进
中级→人民法院
判处→有期徒刑
武器→核查
国会→议员
拿→出
罗斯林→研究所
立案→侦查
压锭→重组
航班→延误
证券→交易所
语言→文字
骑→自行车
个体→工商户
医护→人员
扶贫→攻坚
副→部长
达标→排放
两→国
跨→世纪
核军备→竞赛
出口→退税
南方→共同市场
国务→秘书
援→藏
亚→欧
机动→车辆
工农业→总产值
长江→中下游
才→能
经济界→人士
农业部→乡镇企业局
足球→俱乐部
淮河→流域
实业→有限公司
联络→小组
挂职→锻炼
相→结合
股份→有限公司
任→中共
涉外→税收
天体→物理
趋→缓
中华→医学会
纪检→监察部门
王→大娘
桥本→首相
已→成为
中午→12时
提→速
三峡→库区
家乡→父老
利用→外资
下岗→女工
一→批
十分→重视
集团→董事长
变→得
避难→场所
人均→纯收入
深切→缅怀
一→片
交警→支队
联合国→安理会
跳水→大奖赛
无偿→献血
内蒙古→自治区
珠江→三角洲
就→会
羽毛球→公开赛
朝鲜→半岛
拉开→帷幕
防汛→抗旱
科教→兴
外汇→储备
铁路→分局
投→巨资
一→种
厄尔尼诺→现象
财政→收入
百年→校庆
富康→轿车
农技→推广
水文→地质
成→了
下岗→青工
驻军→某部
不法→商贩
两→个
农用→三轮车
远远→超出
亲身→经历
农田→基本建设
电→记者
欧→亚
大使馆→临时代办
周→总理
科克→首相
采矿→许可证
而→又
住房→公积金
抗日→根据地
秒→钟
防治→荒漠化
国→内
道—琼斯→指数
下岗→职工
奔→小康
神州→大地
距→今
进行→了
仪器→仪表
青年→志愿者
虹桥→旅行社
一审→判决
捡→拾
有关→部门
沿→淮
自己→的
牛→羊
人均→占有量
存款→余额
电子→商务
迁→往
长征→火箭
迎→新春
不良→债权
甲A→联赛
一→份
国务卿→奥尔布赖特
惜→败
亚→太
驻华→大使
这→一
大中专→院校
国防→科工委
很→难
律师→事务所
存款→准备金率
纪检→监察
短期→外债
占用→耕地
钢筋→混凝土
延安→整风
铁路→公安处
某→集团军
赦免→拉那烈
民航→总局
海关→总署
多→名
－－－→访
临时→船闸
集邮→爱好者
做→好
党史→研究室
有线→电视台
杀毒→软件
养老→保险
几→个
特级→大师
本届→杯赛
克林顿→总统
劳务→输出
市委→宣传部
保值→增值
高层→互访
及→其他
保费→收入
我党→我军
严厉→打击
随军→家属
入党→积极分子
秋→冬
分裂主义→分子
海外→侨胞
领导→干部
八达岭→长城
苗族→自治县
及→其
买→卖
华人→华侨
驰名→商标
森林→防火
维希→政权
长→达
面临→着
军区→司令员
牢固→树立
野生→动物
日元→汇率
高级→官员
水污染→防治
孩子→们
首→次
自学→考试
台湾→当局
爷爷→奶奶
青藏→高原
水土→流失
街道→办事处
10→派
森林→覆盖率
国有→资产
台湾→同胞
假冒伪劣→商品
商业→银行
21→世纪
自由→贸易区
造林→绿化
检察→机关
拨→专款
出租车→司机
党支部→书记
江→总书记
反华→势力
航空→公司
不→能
草案→修改稿
高→达
虎→弟弟
慕田峪→长城
乘→专机
一→位
首脑→会议
呈现→出
令→人
博士→学位
贫困→人口
港→澳
犯罪→嫌疑人
驻华→使馆
存款→准备金
公安→机关
失学→儿童
研究所→所长
国有→企业
引→资
直属机关→工委
抗洪→抢险
外来→童
开庭→审理
大学→校长
中兴→通讯
捐→资
应届→毕业生
平稳→过渡
录取→通知书
绿化→美化
防震→减灾
哈佛→大学
济南→军区队
上缴→税金
贪污→贿赂
都→是
折合→人民币
一→家
甲级→联赛
行政性→收费
揭→牌
对口→帮扶
不→会
自筹→资金
老一辈→革命家
制止→奢侈浪费
超→负荷
人均→年收入
飞→抵
降→至
岁→的
盗版→光盘
悉尼→奥运会
1998→年度
大连→万达
国民→阵线
枚→金牌
春耕→备耕
胚胎→细胞
移动→电话
边防→检查站
跌→破
采→血
外出→打工
对口→支援
带→着
国民→生产总值
恐怖→分子
网球→公开赛
证券→营业部
不→够
各界→人士
公安→分局
交通→事故
－－－→记
新春→佳节
税收→征管
上→的
杂交→水稻
已→达
从业→人员
约→合
医疗→器械
反→兴奋剂
娱乐→场所
杭州→艺专
乡亲→们
夫人→希拉里
颇→具
救灾→物资
危重→病人
提前→兑取
凭证式→国债
医科→大学
外来→务工青年
送→到
乌拉圭→回合
叙→黎
海峡→两岸
联邦→议院
首→批
免→收
只→有
闯→红灯
参议院→议长
主场→迎战
东莱街→派出所
－－→记
略→显
华侨→华人
刻苦→钻研
印→巴
大中专→毕业生
输电→线路
撒切尔→夫人
面积→达
显得→格外
致力→于
青岛→海牛队
邓→大姐
电影→制片厂
彩色→胶卷
平民→百姓
提供→了
上升→到
市委→书记
草地→畜牧业
右翼→势力
主管→部门
印度→人民党
跌→至
各→种
紧紧→围绕
居庸关→长城
针→刺
持证→上岗
过往→行人
珠江→钢琴
毛→主席
节水→灌溉
新闻→媒介
议会→党团
黑龙江省→牡丹江市
大连→万达队
音像→制品
浦东→新区
广播→电视
母女→俩
县委→书记
高等→学府
渐→趋
用人→失察
原油→日产量
围棋→名人战
充分→发挥
支→球队
国防部长→莫迪凯
艾滋病→病毒
失学→女童
自谋→职业
挥→汗
’→97
农科教→结合
全场→紧逼
’→98
刑事→案件
总政→歌舞团
宏观→调控
硕士→学位
交警→大队
碱集料→反应
新闻→媒体
营业→网点
拉那烈→亲王
黄土→高原
制→售
率→团
武警→部队
祖国→大陆
VCD→光盘
运→抵
驻华→使节
沿→街
凌晨→2时
作→了
毫→无
余→名
结→硕果
选人→用人
华人→社团
健身→气功
全民→健身
城镇→居民
东→扩
24→小时
金融→机构
违法→违纪
出口→创汇
世界杯→足球赛
范围→内
通车→里程
长野→冬奥会
手→持
物价→涨幅
是→一个
革命→老区
太湖→流域
